##########
#H..I....#
#..##..E.#
#....##..#
#..I.....#
##########